17 15
09 09 09 09 09 09 09 09 09 09 09 09 09 09 09 09 09
01 03 09 04 12 04 09 03 03 03 03 03 09 09 09 09 02
01 03 03 03 11 03 03 03 03 03 03 03 09 04 04 09 02
01 03 03 03 11 03 03 03 03 03 03 03 03 03 03 03 02
01 01 03 03 11 03 03 03 03 11 03 03 03 03 03 03 02
01 01 03 03 11 03 03 03 03 11 11 11 03 03 03 03 02
01 04 03 03 11 03 03 03 03 03 03 11 03 03 03 03 02
01 04 03 03 11 03 03 03 03 03 03 11 03 03 03 03 02
01 01 03 03 11 11 11 11 11 11 11 11 03 03 03 03 02
01 03 03 03 03 03 03 03 11 03 03 03 03 03 03 03 02
01 03 03 03 03 03 03 03 11 03 03 03 03 03 03 03 02
01 01 03 03 03 03 03 03 11 03 03 03 03 03 03 03 02
01 12 11 11 11 11 11 11 11 03 03 03 03 03 03 03 02
01 01 03 03 03 03 03 03 03 03 03 03 03 03 03 03 02
10 10 10 10 10 10 10 10 10 10 10 10 10 10 10 10 10

