27 43
09 09 09 09 09 09 09 09 09 09 09 09 09 09 09 09 09 09 09 09 09 09 09 09 09 09 09
09 09 09 09 09 09 09 09 09 04 03 03 03 03 11 11 11 11 11 11 11 11 11 11 11 12 02
09 09 09 09 09 09 09 09 09 04 03 03 03 03 11 03 03 03 03 03 03 03 03 03 03 04 02
09 09 04 03 03 03 03 02 09 10 10 10 03 03 11 03 03 03 02 09 09 09 09 09 09 09 02
09 09 12 11 11 11 03 02 09 09 09 01 03 03 11 03 03 03 02 09 09 09 09 09 09 09 02
09 09 04 03 03 11 03 02 09 01 04 03 03 03 11 03 03 03 03 03 03 03 03 03 03 04 02
09 09 09 01 01 11 03 02 09 01 04 03 03 03 11 03 10 03 03 03 03 03 03 03 03 04 02
01 03 03 01 01 11 03 02 09 01 04 03 03 03 11 03 09 09 09 09 09 09 09 09 09 09 02
01 03 03 01 01 11 11 03 03 01 04 03 03 03 11 03 02 03 03 03 03 03 03 03 03 03 02
01 03 03 01 01 03 11 03 03 01 04 03 03 03 11 03 02 03 11 11 11 11 11 11 11 03 02
01 03 03 01 01 03 11 03 03 01 04 03 03 03 11 03 02 03 11 03 03 03 03 03 11 03 02
01 03 03 03 03 03 11 03 03 03 09 09 09 09 11 03 03 03 11 03 03 10 10 03 11 10 02
01 03 03 03 03 03 11 03 03 03 02 01 03 03 11 11 03 03 11 03 03 03 02 03 11 03 02
01 03 03 11 11 11 11 11 11 03 02 01 03 03 03 11 03 03 11 03 03 03 02 03 11 03 02
01 03 03 11 03 03 03 03 11 03 02 01 03 03 03 11 03 03 11 03 03 03 02 03 11 03 02
01 10 10 11 10 10 10 03 11 03 03 03 03 03 03 11 03 03 11 11 03 03 02 03 11 03 02
01 09 09 11 09 09 01 03 11 03 03 03 03 03 11 11 11 11 11 11 11 11 11 11 11 03 02
01 01 03 11 03 09 01 03 11 11 11 11 11 11 11 11 11 11 11 11 03 03 03 03 11 03 02
01 01 03 03 03 09 01 03 11 03 03 03 03 03 11 11 11 11 11 03 03 03 10 03 11 03 02
01 01 03 03 03 09 01 03 11 03 03 03 03 03 03 03 03 03 03 03 10 10 09 03 11 03 02
01 03 03 03 03 09 01 03 11 03 10 10 03 03 03 03 03 03 03 03 02 03 02 03 11 03 02
01 03 03 03 03 09 01 03 11 03 01 03 03 03 03 03 03 03 03 03 02 03 02 03 11 03 02
01 03 03 03 03 09 01 03 11 03 01 10 10 10 10 03 03 03 03 03 02 03 02 03 11 03 02
01 03 03 03 03 09 01 03 11 03 03 03 04 09 09 03 03 03 03 03 02 03 02 10 11 03 02
01 03 03 03 03 09 01 03 11 03 03 03 04 09 09 03 03 10 10 10 02 03 03 03 11 03 02
01 03 03 03 03 09 01 11 11 11 11 11 04 09 09 10 10 09 03 03 03 03 11 11 11 03 02
01 03 03 03 03 09 03 11 03 03 03 03 09 09 09 04 04 03 03 03 03 03 03 03 03 03 02
10 10 10 10 10 10 03 11 10 10 10 10 10 10 10 10 10 10 10 10 10 10 10 10 10 10 02
09 09 09 09 09 09 03 11 03 09 09 09 09 09 09 09 09 01 01 03 03 11 03 03 03 03 02
01 03 09 04 12 04 03 11 03 03 03 03 09 09 09 09 02 01 01 03 03 11 03 03 03 03 02
01 03 03 03 11 03 03 03 03 03 03 03 09 04 04 09 02 01 01 03 03 11 03 03 03 03 02
01 03 03 03 11 03 03 03 03 03 03 03 03 03 03 03 02 01 01 03 03 11 03 03 03 03 02
01 01 03 03 11 03 03 03 03 11 03 03 03 03 03 03 02 01 01 03 03 11 03 03 03 03 02
01 01 03 03 11 03 03 03 03 11 11 11 03 03 03 03 02 01 01 03 03 11 03 03 03 03 02
01 04 03 03 11 03 03 03 03 03 03 11 03 03 03 03 03 01 01 03 03 11 03 03 03 03 02
01 04 03 03 11 03 03 03 03 03 03 11 11 11 11 11 11 01 01 03 03 11 03 03 03 03 02
01 01 03 03 11 11 11 11 11 11 11 11 03 03 03 03 03 01 01 03 03 11 03 03 03 03 02
01 03 03 03 03 03 03 03 11 03 03 03 03 03 03 03 02 01 01 03 03 11 03 03 03 03 02
01 03 03 03 03 03 03 03 11 03 03 03 03 03 03 03 02 01 01 03 03 11 03 03 03 03 02
01 01 03 03 03 03 03 03 11 03 03 03 03 03 03 03 02 01 01 03 03 11 03 03 03 03 02
01 12 11 11 11 11 11 11 11 03 03 03 03 03 03 03 02 01 01 03 03 11 03 03 03 03 02
01 01 03 03 03 03 03 03 03 03 03 03 03 03 03 03 02 01 01 03 03 11 03 03 03 03 02
10 10 10 10 10 10 10 10 10 10 10 10 10 10 10 10 10 01 01 03 03 11 03 03 03 03 02

