49 20
00 00 00 00 00 00 00 00 00 00 00 00 00 00 00 00 00 00 00 00 00 00 00 00 00 00 00 00 00 00 00 00 00 00 00 00 00 00 00 00 00 00 00 00 00 00 00 00 00
00 00 00 00 00 00 00 00 00 00 00 00 00 00 00 00 00 00 00 00 00 00 00 00 00 00 00 00 00 00 00 00 00 00 00 00 00 00 00 00 00 00 00 00 00 00 00 00 00
00 00 00 00 00 00 00 00 00 00 00 00 00 00 00 00 00 00 00 00 31 01 02 01 02 32 00 00 00 00 00 00 00 00 00 00 00 00 00 00 00 00 00 00 00 00 00 00 00
00 00 00 00 00 00 00 00 00 00 00 00 00 00 00 00 00 00 00 00 43 14 14 14 13 44 00 00 00 00 00 00 00 00 00 00 00 00 00 00 00 00 00 00 00 00 00 00 00
00 00 00 00 00 00 00 00 00 00 00 00 00 00 00 00 00 00 00 00 37 13 14 13 14 38 00 00 00 00 00 00 00 00 00 00 00 00 00 00 00 00 00 00 00 00 00 00 00
00 00 00 00 00 00 00 00 00 00 00 00 00 00 00 00 00 00 00 00 39 40 41 39 40 41 39 00 00 00 00 00 00 00 00 00 00 00 00 00 00 00 00 00 00 00 00 00 00
00 00 00 00 00 00 00 00 00 00 00 00 00 00 00 00 00 00 00 00 42 42 42 42 42 42 42 00 00 00 00 00 00 00 00 00 00 00 00 00 00 00 00 00 00 00 00 00 00
00 00 00 00 00 00 00 00 00 00 00 00 00 00 00 00 00 00 00 00 42 42 42 42 42 42 42 00 00 00 00 00 00 00 00 00 00 00 00 00 00 00 00 00 00 00 00 00 00
00 00 00 00 00 00 00 00 00 00 00 00 00 00 00 00 00 00 00 00 42 42 42 42 42 42 42 00 00 00 00 00 00 00 00 00 00 00 00 00 00 00 00 00 00 00 00 00 00
00 00 00 00 00 00 00 00 00 00 00 00 00 00 00 00 00 00 00 31 51 52 53 51 51 52 53 32 00 00 00 00 00 00 00 00 00 00 00 00 00 00 00 00 00 00 00 00 00
00 00 00 00 00 00 00 00 00 00 00 00 00 00 00 00 00 00 00 43 25 26 25 14 13 14 26 44 00 00 00 00 00 00 00 00 00 00 00 00 00 00 00 00 00 00 00 00 00
02 01 02 02 01 02 02 01 02 01 01 02 01 02 02 02 01 02 01 26 13 14 25 26 13 14 25 26 13 32 00 00 00 00 00 31 13 14 25 26 13 14 25 26 13 14 25 26 13
14 25 26 13 14 25 26 13 14 25 26 13 14 25 26 13 14 25 26 13 14 25 26 13 14 25 26 13 14 44 00 00 00 00 00 43 14 25 26 13 14 25 26 13 14 25 26 13 14
26 13 14 25 26 13 14 25 26 13 14 25 26 13 14 25 26 13 14 25 26 13 14 25 26 13 14 25 26 44 00 00 00 00 00 43 26 13 14 25 26 13 14 25 26 13 14 25 26
13 14 25 26 13 14 25 26 13 14 25 26 13 14 25 26 13 14 25 26 13 14 25 26 13 14 25 26 13 44 00 00 00 00 00 43 13 14 25 26 13 14 25 26 13 14 25 26 13
14 25 26 13 14 25 26 13 14 25 26 13 14 25 26 13 14 25 26 13 14 25 26 13 14 25 26 13 14 38 00 00 00 00 00 43 14 25 26 13 14 25 26 13 14 25 26 13 14
26 13 14 25 26 13 14 25 26 13 14 25 26 13 14 25 26 13 14 25 26 13 14 25 26 13 14 25 26 13 00 00 00 00 00 37 26 13 14 25 26 13 14 25 26 13 14 25 26
25 26 13 14 25 26 13 14 25 26 13 14 25 26 13 14 25 26 13 14 25 26 13 14 25 26 13 14 25 26 00 00 00 00 00 14 25 26 13 14 25 26 13 14 25 26 13 14 25
14 25 26 13 14 25 26 13 14 25 26 13 14 25 26 13 14 25 26 13 14 25 26 13 14 25 26 13 14 25 00 00 00 00 00 13 14 25 26 13 14 25 26 13 14 25 26 13 14
13 14 25 26 13 14 25 26 13 14 25 26 13 14 25 26 13 14 25 26 13 14 25 26 13 14 25 26 13 14 14 14 14 14 14 26 13 14 25 26 13 14 25 26 13 14 25 26 13
